1011111101
1100110011
1010110101
1001111001
1000110001
1010110001
1010110001
1011110001
1000000001
0000000000