0010000100
0101001010
1000110001
1000110001
1001001001
1010000101
1100000011
1000000001
0100000010
0011111100