1010110101
0101001010
0010110100
0001001000
0000110000
0000110000
0000000000
0000000000
0000000000
0000000000